#..............
#..............
#..............
#..............
#..............
#.B............
#BBB.@........#
###############
~
...jek.........
...cee.........
...kej.........
...eec.........
...jek.........
...ghi.........
...cfc.........
6262626........
~
..aeeeb........
..aceeb........
..aeeeb........
..aeeeb........
..aeeeb........
..aeeeb........
B.aeeeb........
626262626262626