#..............
#..............
#.@............
#..............
#.............#
###...........#
##########....#
###############