#..............
#..............
#..............
#..............
#..............
#..............
###.....####.##
###############